####################
####################
##********g*******##
##*####*##g ##*##*##
##*####*#g g #*##*##
##**p***##  ##*##*##
##*##*************##
##*####*#####*###*##
##*####*#####*###*##
##****************##
##*##*###########*##
##*##*###########*##
##****************##
####################
####################